!!
!!  偵察戦力緊急展開！「光」作戦 (2017年 冬)
!!
い13	伊13	固有一般	巡潜甲型改二 1番艦
い14	伊14	固有一般	巡潜甲型改二 2番艦
い15	伊15	固有一般	巡潜甲型改二 3番艦
!!
!!  出撃！北東方面 第五艦隊 (2017年 春)
!!
しむしゅ	占守	固有一般	占守型海防艦 1番艦
くなしり	国後	固有一般	占守型海防艦 2番艦
いしがき	石垣	固有一般	占守型海防艦 3番艦
はちじょう	八丈	固有一般	占守型海防艦 4番艦
えとろふ	択捉	固有一般	択捉型海防艦 1番艦
まつわ	松輪	固有一般	択捉型海防艦 2番艦
さど	佐渡	固有一般	択捉型海防艦 3番艦
おき	隠岐	固有一般	択捉型海防艦 4番艦
むつれ	六連	固有一般	択捉型海防艦 5番艦
いき	壱岐	固有一般	択捉型海防艦 6番艦
つしま	対馬	固有一般	択捉型海防艦 7番艦
わかみや	若宮	固有一般	択捉型海防艦 8番艦
ひらと	平戸	固有一般	択捉型海防艦 9番艦
ふくえ	福江	固有一般	択捉型海防艦 10番艦
あまくさ	天草	固有一般	択捉型海防艦 11番艦
まんじゅ	満珠	固有一般	択捉型海防艦 12番艦
かんじゅ	干珠	固有一般	択捉型海防艦 13番艦
かさど	笠戸	固有一般	択捉型海防艦 14番艦
かもい	神威	固有一般	神威型補給艦 1番艦
かすがまる	春日丸	固有一般	春日丸型軽空母 1番艦
たいよう	大鷹	固有一般	大鷹型軽空母 1番艦
たいようかい	大鷹改	固有一般	大鷹型軽空母 1番艦
たいようかいに	大鷹改二	固有一般	大鷹型軽空母 1番艦
がんぐーと	Гангут	固有一般	Гангут型戦艦 1番艦
がんぐーと	Октябрьская революция	固有一般	Гангут型戦艦 1番艦
がんぐーと	Гангут два	固有一般	Гангут型戦艦 1番艦
おくちゃぶりすかやれヴぉりゅーつぃや	Октябрьская революция	固有一般	Гангут型戦艦 1番艦
がんぐーとかい	Октябрьская революция	固有一般	Гангут型戦艦 1番艦
がんぐーとかいに	Гангут два	固有一般	Гангут型戦艦 1番艦
ぺとろぱぶろふすく	Петропавловск	固有一般	Гангут型戦艦 2番艦
まらーと	Марат	固有一般	Гангут型戦艦 2番艦
ぽるたわ	Полтава	固有一般	Гангут型戦艦 3番艦
たんご	丹後	固有一般	Гангут型戦艦 3番艦
ちぇすま	Чесма	固有一般	Гангут型戦艦 3番艦
せばすとーぽり	Севастополь	固有一般	Гангут型戦艦 4番艦
ぱりじすかやこんむな	Парижская коммуна	固有一般	Гангут型戦艦 4番艦
